##############
#   #  A     #
#   #  ##### #
#      #  ## #
######### #  #
#        B# ##
# ######  #  #
#   #  # ### #
#   #     #  #
##############