                              
      #######                  
  ### #B #  #              ####
  # ###  #  #              #  #
  #     ## #################  #
  #         #                 #
 ##  #####  # ##### #######   #
 #   #   # ## #           #   #
 #   #   #    #           #####
 #####   ######            
