                              
      #######                  
  ### #B #  #    d         ####
  # ###  #  #              #  #
  #     ## #################  #
  #         #               A #
 ##  #####  # ##### #######   #
 #   #   # ## #           #   #
 #   #   #    #           #####
 #####   ######            
