                               
      #######                  
  ### #B #  #              ####
  # ###. #  #              #  #
  #    .## #################  #
  #    .... #...............A #
 ##  #####. #.##### #######   #
 #   #   #.##.#           #   #
 #   #   #....#           #####
 #####   ######                
